00000000000000000000000000000000000000000000000000000000000
00000000000000000000000000000000000000000000000000000000000
00000000000000000000000000000000000000000000000000000000000
XXXXXXX0XXXXXXXXXX000000XXXXXXXX000000000000000000000000000
X0000000000000000000000000000000000000000000000000000000000
0000000000000000000000000000000000000GGGGG0G0GGGGG0000GGQGG
00000000000000000XXXXXXXXX000XXX00000XXXXXXXXXXXXX0000XXXXX
0000000000000000000000000000000000000000000000000000000000X
0000000000000XXX000000000000000000000000000000000000000000X
0000000000000000000000000000000000000000000000G00000000000X
000000000000000000000000000000000000000000000G0000000000000
000000000XXX000000000000000000000000000000000000G0000000000
X000000000000000000000000000000000000000000000000000000000X
X00P000000000000000000000000000000★00000000XX0000000000000X
XXXXXXXX0000000000000000000XXXXX0XXXXXXXXX0000000XXXXX0XXXX
00000000000000000000000000000000000000000000000000000000000
000000000000000000000000000000000000000000000000000000XXXXX
YYYYYYYYYYYYYYYYYYYYYYYYYYYYYYYY000000000000000000000000000
